NO ./path_to_the_north_texture
SO ./path_to_the_south_texture

F 220,100,0


  EA  ./path_to_the_east_texture
  WE   ./path_to_the_west_texture 

C 255,200,3

11111111111111111111111111111
    1000000000110000000000001
    1000000000110000000000001
    1011000001110000000E00001
    100100000000000000100011
    111111111111111111111111