NO ./llados.xpm
SO ./llados.xpm

F 220,100,0


  EA ./llados.xpm
  WE ./llados.xpm

C 255,200,3

11111111111111111111111111111
    1000000000110000000000001
    1000000000110000000000001
    1011000001110000000S00001
    1001000000010000000000001
    1111111111111111111111111